32
0 1 7 1 1 8 1 0
1 1 1 1 1 1 1 1
8 1 1 1 1 1 1 9
1 1 1 1 1 1 1 1
1 1 1 1 1 1 1 1
1 1 1 1 1 1 1 1
1 1 1 1 1 1 1 1
1 1 1 1 1 1 1 1
1 1 1 1 1 1 1 1
0 1 1 1 1 1 1 0
30
5
1
4